NO ./textures/north_texture.png
SO ./textures/south_texture.png
WE ./textures/west_texture.png
EA ./textures/east_texture.png
DOOR ./textures/door_texture.png

ANIMATED ./textures/tree/tree00.png
ANIMATED        ./textures/tree/tree01.png
ANIMATED ./textures/tree/tree02.png
ANIMATED ./textures/tree/tree03.png
ANIMATED ./textures/tree/tree04.png
ANIMATED ./textures/tree/tree05.png


F 96,96,96
C 204,255,255

        1111111111111111111111111
        1000000000110000000000001
        1011000001110000000000001
        1001000000000000000000001
111111111011000001110000000000001
100000000011000001110111111111111
11110111111111011100000010001
11110111111111011101010010001
11000000110101011100000010001
100000000000000011000000101D1
10000000000000001101010010001
110000011101010111110110D0N0111
11110111 1110101 101011010001
11111111 1110111 111011111011
        1111011111110111110111111
        1000000000110000000000001
        1011000001110000000000001
        1001000000000000000000001
111111111011000001110000000000001
100000000011000001110111111111111
11110111111111011100000010001
11110111111111011101010010001
11000000110101011100000010001
10000000000000001100000010001
10000000000000001101010010001
110000011101010111110111100111
11110111 1110101 101111010001
11111111 1111111 111111111111
