






NO ./textures/north_texture.png








SO ./textures/south_texture.png
                        WE ./textures/west_texture.png
        EA ./textures/east_texture.png

        F 20,           20,             20
C 200,          200,200

111111
10001
10001
10001
100001
100001
110001
100001
100001
100001
100001
10N001
111111























