NO ./textures/north_texture.png
SO ./textures/south_texture.png
WE ./textures/west_texture.png
EA ./textures/east_texture.png
DOOR ./textures/door_texture.png


F 207, 192, 157
C 211, 187, 221

        1111111111111111111111111
        1000000000110000000000001
        1011000001110000000000001
        1001000000000000000000001
11111111100D000001110000000000001
10000000001100001110111111111111
11110111111111010100000010001
11110111111111010101010010001
11000000110101010000001000001
10000000000000001100000010001
10000000000000001101010010111
110000011101010111110110DN001
11110111 1110101 101111010001
11111111 1111111 111111111111
