   WE                            ./textures/west_texture.png
NO                ./textures/north_texture.png



SO ./textures/south_texture.png

F      17,    38,     64

EA ./textures/east_texture.png



C 218, 234, 235

1111111111111111111111111
1000110000100000000000001
1000110E00000000111111001
1000110000000000110001001
1TTT00TTTT100T00000001001
1111111111111111111111111

