NO /textures/
SO /textures/
WE /textures/
EA /textures/

F 255,100,0
C 255,20,0

111111111111111111111111111111
1N0000000100000100000100000001
101001010010000010100100010101
101001001010101000100100010101
110000000111100000000010000011
111111111111111111111111111111
