NO ./textures/east_texture.png
SO ./textures/north_texture.png
WE ./textures/south_texture.png
EA ./textures/west_texture.png

F 255,100,0
C 255,20,0

111111111111111111111111111111
1W1000000100000100000100000001
101001010010000010100100010101
101001001010101000101000101011
110000000111100000000010000011
111111111111111111111111111111
