NO /textures/
SO /textures/
WE /textures/
EA /textures/

F 255,100,0
C 255,20,0

111111111111111111111111111111
1W1000000100000100000100000001
1010010100100000101C0100010101
101001001010101000101000101011
110000000111100000000010000011
111111111111111111111111111111
